{
	"type": "custommachinery:custom_machine",
	"machine": "custommachinery:clean_room",
	"time": 8,
	"requirements": [
        {
            "type": "custommachinery:block",
            "mode": "output",
            "action": "destroy",
            "pos": [-8, 0, -8, 8, 8, -1],
            "filter": ["adpother:carbon", "adpother:dust", "adpother:sulfur"],
            "whitelist": true
        },
        {
            "type": "custommachinery:energy",
            "mode": "input",
            "amount": 4000,
            "chance": 1.0
        },
        {
            "type": "custommachinery:item",
            "mode": "output",
            "item": "kubejs:sludge_dust",
            "amount": 1,
            "chance": 0.10
        },
        {
            "type": "custommachinery:structure",
            "pattern": [
                [
                    "+++++++++++++++++",
                    "+++++++++++++++++",
                    "+++++++++++++++++",
                    "+++++++++++++++++",
                    "+++++++++++++++++",
                    "+++++++++++++++++",
                    "+++++++++++++++++",
                    "+++++++++++++++++",
                    "        m        "
                  ],
                  [
                    "+++++++++++++++++",
                    "+               +",
                    "+               +",
                    "+               +",
                    "+               +",
                    "+               +",
                    "+               +",
                    "++++++++ ++++++++",
                    "                 "
                  ],
                  [
                    "+++++++++++++++++",
                    "+               +",
                    "+               +",
                    "+               +",
                    "+               +",
                    "+               +",
                    "+               +",
                    "++++++++ ++++++++",
                    "                 "
                  ],
                  [
                    "+++++++++++++++++",
                    "+               +",
                    "+               +",
                    "+               +",
                    "+               +",
                    "+               +",
                    "+               +",
                    "+++++++++++++++++",
                    "                 "
                  ],
                  [
                    "+++++++++++++++++",
                    "+               +",
                    "+               +",
                    "+               +",
                    "+               +",
                    "+               +",
                    "+               +",
                    "+++++++++++++++++",
                    "                 "
                  ],
                  [
                    "+++++++++++++++++",
                    "+               +",
                    "+               +",
                    "+               +",
                    "+               +",
                    "+               +",
                    "+               +",
                    "+++++++++++++++++",
                    "                 "
                  ],
                  [
                    "+++++++++++++++++",
                    "+               +",
                    "+               +",
                    "+               +",
                    "+               +",
                    "+               +",
                    "+               +",
                    "+++++++++++++++++",
                    "                 "
                  ],
                  [

                    "+++++++++++++++++",
                    "+               +",
                    "+               +",
                    "+               +",
                    "+               +",
                    "+               +",
                    "+               +",
                    "+++++++++++++++++",
                    "                 "
                  ],
                  [
                    "+++++++++++++++++",
                    "+++++++++++++++++",
                    "+++++++++++++++++",
                    "+++++++++++++++++",
                    "+++++++++++++++++",
                    "+++++++++++++++++",
                    "+++++++++++++++++",
                    "+++++++++++++++++",
                    "                 "
                  ]
            ],
            "keys": {
                "+": "#mekanismadditions:plastic_blocks"
            }
        }        
	]
}